 1; 0; 0; 3; 0; 0; 0; 0; 0; 0;
 1; 0; 0; 3; 0; 0; 2; 0; 0; 0;
 1; 0; 0; 3; 0; 0; 2; 0; 0; 0;
 1; 4; 4; 4; 0; 0; 2; 0; 0; 0;
 1; 0; 0; 0; 0; 0; 2; 0; 0; 0;
 0; 0; 0; 0; 0; 5; 5; 0; 0; 0;
 0; 0; 0; 0; 0; 0; 0; 0; 0; 0;
 0; 0; 0; 0; 0; 0; 0; 0; 0; 0;
 0; 0; 0; 0; 0; 0; 0; 0; 0; 0;
 0; 0; 0; 0; 0; 0; 0; 0; 0; 0;
