 0; 0; 0; 0; 0; 0; 0; 0; 0; 0;
 0; 0; 0; 0; 0; 0; 0; 0; 0; 0;
 4; 0; 0; 0; 0; 0; 0; 0; 0; 1;
 4; 0; 0; 0; 0; 0; 0; 0; 0; 1;
 4; 0; 0; 0; 0; 0; 0; 0; 0; 1;
 3; 0; 0; 0; 0; 0; 0; 0; 0; 1;
 3; 0; 0; 0; 0; 0; 0; 0; 0; 1;
 3; 0; 0; 5; 5; 2; 2; 2; 2; 0;
 0; 0; 0; 0; 0; 0; 0; 0; 0; 0;
 0; 0; 0; 0; 0; 0; 0; 0; 0; 0;
