 0; 0; 0; 0; 0; 0; 4; 4; 4; 0;
 0; 0; 0; 0; 0; 0; 0; 0; 0; 0;
 0; 0; 0; 0; 0; 0; 0; 0; 0; 0;
 0; 0; 0; 0; 0; 0; 0; 0; 0; 0;
 0; 0; 0; 0; 0; 0; 0; 0; 1; 0;
 0; 0; 0; 0; 0; 0; 0; 0; 1; 0;
 0; 0; 0; 2; 2; 2; 2; 3; 1; 0;
 0; 0; 0; 0; 0; 0; 0; 3; 1; 0;
 0; 0; 0; 5; 5; 0; 0; 3; 1; 0;
 0; 0; 0; 0; 0; 0; 0; 0; 0; 0;
