 0; 0; 0; 0; 0; 0; 0; 0; 0; 0;
 0; 0; 1; 0; 2; 0; 0; 4; 0; 0;
 0; 0; 1; 3; 2; 0; 0; 4; 0; 0;
 0; 0; 1; 3; 2; 0; 0; 4; 0; 0;
 0; 0; 1; 3; 2; 5; 5; 0; 0; 0;
 0; 0; 1; 0; 0; 0; 0; 0; 0; 0;
 0; 0; 0; 0; 0; 0; 0; 0; 0; 0;
 0; 0; 0; 0; 0; 0; 0; 0; 0; 0;
 0; 0; 0; 0; 0; 0; 0; 0; 0; 0;
 0; 0; 0; 0; 0; 0; 0; 0; 0; 0;
