 0; 0; 0; 0; 0; 0; 0; 0; 0; 0;
 0; 0; 0; 0; 0; 0; 0; 0; 0; 0;
 0; 0; 0; 0; 0; 0; 2; 0; 0; 0;
 0; 0; 0; 0; 0; 0; 2; 1; 0; 0;
 0; 0; 0; 0; 0; 0; 2; 1; 0; 0;
 0; 0; 0; 0; 0; 3; 2; 1; 0; 0;
 0; 0; 4; 0; 0; 3; 0; 1; 0; 0;
 0; 0; 4; 5; 5; 3; 0; 1; 0; 0;
 0; 0; 4; 0; 0; 0; 0; 0; 0; 0;
 0; 0; 0; 0; 0; 0; 0; 0; 0; 0;
