 0; 0; 1; 5; 0; 0; 0; 0; 0; 0;
 0; 0; 1; 5; 0; 0; 0; 0; 0; 0;
 0; 0; 1; 0; 2; 2; 2; 2; 0; 0;
 0; 0; 1; 4; 4; 4; 0; 0; 0; 0;
 0; 0; 1; 3; 0; 0; 0; 0; 0; 0;
 0; 0; 0; 3; 0; 0; 0; 0; 0; 0;
 0; 0; 0; 3; 0; 0; 0; 0; 0; 0;
 0; 0; 0; 0; 0; 0; 0; 0; 0; 0;
 0; 0; 0; 0; 0; 0; 0; 0; 0; 0;
 0; 0; 0; 0; 0; 0; 0; 0; 0; 0;
